{
  "layers": [
    {
      "tileset": "Asphalt road",
      "z_order": 1,
      "map": [
        [   8,    9,    4,    4,    4,    4,    4,    4,   10,   11],

        [  26,   27,   40,   40,   40,   40,   40,   40,   40,   29],

        [  21,   23,    3,    2,    2,    2,    2,    2,    2,   41],

        [  21,   23,   39,    2,    2,    2,    2,    2,    2,    5],

        [  44,   45,    4,    4,    4,    4,    4,    4,    4,   47],

        [  62,   63,   40,   40,   40,   40,   40,   40,   64,   65]
      ]
    },
    {
      "tileset": "Grass",
      "z_order": 0,
      "map": [
        [   4,    4,    4,    4,    4,    4,    4,    4,    4,    4],
        [   4,    4,    4,    4,    4,    4,    4,    4,    4,    4],
        [   4,    4,    4,    4,    4,    4,    4,    4,    4,    4],
        [   4,    4,    4,    4,    4,    4,    4,    4,    4,    4],
        [   4,    4,    4,    4,    4,    4,    4,    4,    4,    4],
        [   4,    4,    4,    4,    4,    4,    4,    4,    4,    4]
      ]
    }
  ]
}
